{
  " ": 0,
  "!": 1,
  "#": 2,
  "&": 3,
  "(": 4,
  ")": 5,
  "*": 6,
  "+": 7,
  ",": 8,
  "-": 9,
  ".": 10,
  "/": 11,
  "0": 12,
  "1": 13,
  "2": 14,
  "3": 15,
  "4": 16,
  "5": 17,
  "6": 18,
  "7": 19,
  "8": 20,
  "9": 21,
  ":": 22,
  ";": 23,
  "<": 24,
  "=": 25,
  ">": 26,
  "A": 27,
  "B": 28,
  "C": 29,
  "D": 30,
  "E": 31,
  "F": 32,
  "G": 33,
  "H": 34,
  "I": 35,
  "J": 36,
  "K": 37,
  "L": 38,
  "M": 39,
  "N": 40,
  "O": 41,
  "P": 42,
  "Q": 43,
  "R": 44,
  "S": 45,
  "T": 46,
  "U": 47,
  "V": 48,
  "W": 49,
  "X": 50,
  "Y": 51,
  "Z": 52,
  "[": 53,
  "\\": 54,
  "]": 55,
  "^": 56,
  "_": 57,
  "a": 58,
  "b": 59,
  "c": 60,
  "d": 61,
  "e": 62,
  "f": 63,
  "g": 64,
  "h": 65,
  "i": 66,
  "j": 67,
  "k": 68,
  "l": 69,
  "m": 70,
  "n": 71,
  "o": 72,
  "p": 73,
  "q": 74,
  "r": 75,
  "s": 76,
  "t": 77,
  "u": 78,
  "v": 79,
  "w": 80,
  "x": 81,
  "y": 82,
  "z": 83,
  "{": 84,
  "|": 85,
  "}": 86
}